11111111111111111111111111111111111111111111111111111111111111111111111111111111111111111111111111111111111111111111111111111111
11111111111111111111111111111111111111111111111111111111111111111111111111111111111111111111111111111111111111111111111111111111
11111111111111111112222222222222222211111111111111112222222222222222222222222211111222222222222222211111111111111111111111111111
11111111111111111170000000000000000000000000000000000000000000000000000000000000000000000000000000000000000000081111111111111111
11111111111222221700000000000000000000000000000000000000000000000000000000000000000000000000000000000000000000008111111111111111
11111111170000000000000000000000000000000000000000000000000000000000000000000000000000000000000000000000000000000811111111111111
11111111700000000000000000000000000000000000000000000000000000000000000000000000000000000000000000000000000000000081111111111111
11111117000000000000000000000000000000000000000000000000000000000000000000000000000000000000000000000000000000000000081111111111
11111170000000000000000000000000000000000000000000000000000000000000000000000000000000000000000000000000000000000000008111111111
11111700000000000000000000000000000000000000000000000000000000000000000000000000000000000000000000000000000000000000000811111111
11117000000000000000000000000000000000000000000000000000000000000000000000000000000000000000000000000000000000000000000081111111
11100000000000000000000000000000000000000000000000000000000000000000000000000000000000000000000000000000000000000000000008111111
11100000000000000000000000000000000000000000000000000000000000000000000000000000000000000000000000000000000000000000000000811111
11100000000000000000000000000000000000000000000000000000000000000000000000000000000000000000000000000000000000000000000000081111
11100000000000000000000000000000000000000111111111111000000000000000000000000000000000000011111111111100000000000000000000001111
11100000000000000000000000000000000000000000000000000000000000000000000000000000000000000000000000000000000000000000000000001111
11100000000000000000000000000000000000000000000000000000000000000000000000000000000000000000000000000000000000000000000000001111
11111111111111110000000000000000000000000000000000000000000000000000000000000000000000000000000000000000000000000000000000001111
11100000000000000000000000000000000000000000000000000000000000000000000000000000000000000000000000000000000000000000000000001111
11100000000000000000000000001111111111111111111111111111111111111111111111111111111111111111111111111111110000000000000000001111
11100000000000000000000000001111112222222222222222222222222222211111111111111111111111111111111111111111110000000000000000001111
11100000000000000000000000001111170000000000000000000000000000000000000000000000000000000000000000000000000000000000000000001111
11100000000000001111111111111111700000000000000000000000000000000000000000000000000000000000000000000000000000000000000000001111
11100000000000000000000000001117000000000000000000000000000000000000000000000000000000000000000000000000000000000000000000001111
11100000000000000000000000001170000000000000000000000000000000000000000000000000000000000000000000000000000000000000000000001111
11100000000000000000000000001100000000000000000000000000000000000000000000000000000000000000000000000000000000000000000000001111
11100000000000000000000000001100000000000000000000000000000000000000000000000000000000000000000000000000000000000000000000001111
11111111111111110000000000001100000000000000000000000000000000000000000000000000000000000000000000000000000000000000000000001111
11100000000000000000000000001100000000000000000000000000000000000000000000000000000000000000000000000000000000000000000000001111
11100000000000000000000000001100000000000000000000000000000000000000000000000000000000000000000000000000000000000000000000001111
11100000000000000000000000001100000000000000000000000000000000000000000000000000000000000000000000000000000000000000000000001111
11100000000000000000000000001100000000000000000111111111111111111111111111111111111111111111111111111111111111111111111111111111
11100000000000000000000000001100000000000000000111112222222222222222222222222222211111111111111111111111111111111111111111111111
11100000000000001111111111111100000000000000000000000000000000000000000000000000000000000000000000000000000000000000811111111111
11100000000000000000000000001100000000000000000000000000000000000000000000000000000000000000000000000000000000000000081111111111
11100000000000000000000000001100000000000000000000000000000000000000000000000000000000000000000000000000000000000000000811111111
11100000000000000000000000001100000000000000000000000000000000000000000000000000000000000000000000000000000000000000000081111111
11100000000000000000000000001100000000000000000000000000000000000000000000000000000000000000000000000000000000000000000008111111
11100000000000000000000000001100001111111100000000000000000000000000000000000000000000000000000000000000000000000000000000811111
11111111111111110000000000001100000000000000000000000000000000000000000000000000000000000000000000000000000000000000000000001111
11100000000000000000000000001100000000000000000000000000000000000000000000000000000000000000000000000000000000000000000000001111
11100000000000000000000000001100000000000000000000000000000000000000000000000000000000000000000000000000000000000000000000001111
11100000000000000000000000001111111111111111111111111111111111111111111111111111111111111111111111111111110000000000000000001111
11100000000000000000000000001111111111111111111111111111111111111111111111111222222222222222222222222222110000000000000000001111
11100000000000000000000000001100000000000000000000000000000000000000000000000000000000000000000000000000000000000000000000001111
11100000000000001111111111111100000000000000000000000000000000000000000000000000000000000000000000000000000000000000000000001111
11100000000000000000000000001100000000000000000000000000000000000000000000000000000000000000000000000000000000000000000000001111
11100000000000000000000000001100000000000000000000000000000000000000000000000000000000000000000000000000000000000000000000001111
11100000000000000000000000001100000000000000000000000000000000000000000000000000000000000000000000000000000000000000000000001111
11100000000000000000000000001100000000000000000000000000000000000000000000000000000000000000000000000000000000000000000000001111
11100000000000000000000000001100000000000000033333330000000000000000000000000000000000000000000000000000000000000000000000001111
11111111111111110000000000001100000000000001111111111110000000000000000000000000000000000000000000000000000000000000000000001111
11100000000000000000000000001100000000000000000000000000000000000000000000000000000000000000000000000000000001111111111100001111
11100000000000000000000000001100000000000000000000000000000000000000000000000000000000000000000000000000000000000000000000001111
11100000000000000000000000004400000000000000000000000000000000000000000000000000000000000000000000000000000000000000000000001111
11100000000000000000000000004400000000000000000000000000000000000000000000000000000000000000000000000000000000000000000000001111
11100000000000000000000000004400000000000000000000000000000000000000000000000000000000000000000000000000000000000000000000001111
11111111111111111111111111111111111111111111111111111111111111111111111111111111111111111111111111111111111111111111111111111111
11111111111111111111111111111111111111111111111111111111111111111111111111111111111111111111111111111111111111111111111111111111
11111111111111111111111111111111111111111111111111111111111111111111111111111111111111111111111111111111111111111111111111111111